F 255,30,1
C 225,30,0

NO ./no_texture

SO ./so_texture

WE ./we_texture






EA ./ea_texture

 11
100N0011
111111111
111

