F 255,30,
C 225,30,0

NO ./no_texture
SO ./so_texture
WE ./we_texture
EA ./ea_texture

 11111 1
100N001011
 1101111
11111111
111

