F 255,30,1
C 225,30,0

NO ./no_texture

SO ./so_texture

WE ./we_texture






EA ./ea_texture

 11111
100N0011
    11
11111111
111

